10
##########E##########
# ######## #        #
# ##       ######## #
# ########          #
#          ##########
# ###################
#           #########
# #########         #
# #         ####### #
#####################
