5
########
E      #
### ####
### ####
###S####