74
#######################################################E#######################################################
#                                                                                                             #
#                                                                                                             #
#                                                                                                             #
#                                                                                                             #
#                                                                                                             #
#                                                                                                             #
#                                                                                                             #
#                                                                                                             #
#                                                                                                             #
#                                                                                                             #
#                                                                                                             #
#                                                                                                             #
#                                                                                                             #
#                                                                                                             #
#                                                                                                             #
#                                                                                                             #
#                                                                                                             #
#                                                                                                             #
#                                                                                                             #
#                                                                                                             #
#                                                                                                             #
#                                                                                                             #
#                                                                                                             #
#                                                                                                             #
#                                                                                                             #
#                                                                                                             #
#                                                                                                             #
#                                                                                                             #
#                                                                                                             #
#                                                                                                             #
#                                                                                                             #
#                                                                                                             #
#                                                                                                             #
#                                                                                                             #
#                                                                                                             #
#                                                                                                             #
#                                                                                                             #
#                                                                                                             #
#                                                                                                             #
#                                                                                                             #
#                                                                                                             #
#                                                                                                             #
#                                                                                                             #
#                                                                                                             #
#                                                                                                             #
#                                                                                                             #
#                                                                                                             #
#                                                                                                             #
#                                                                                                             #
#                                                                                                             #
#                                                                                                             #
#                                                                                                             #
#                                                                                                             #
#                                                                                                             #
#                                                                                                             #
#                                                                                                             #
#                                                                                                             #
#                                                                                                             #
#                                                                                                             #
#                                                                                                             #
#                                                                                                             #
#                                                                                                             #
#                                                                                                             #
#                                                                                                             #
#                                                                                                             #
#                                                                                                             #
#                                                                                                             #
#                                                                                                             #
#                                                                                                             #
#                                                                                                             #
#                                                                                                             #
#                                                                                                             #
#######################################################S#######################################################