5
#E#######
# ##    #
# #######
#       S
#########