10
##########E##########
# ######## #        ###
# ##       ######## #
# ########          ######
#          ##########
# ####################
#           #########
# #########         #####
# #         ####### #
###################S#
