31
#E################################
# ##            ##            ## #
# ## ########## ## ########## ## #
# ## #          ##          # ## #
# ## # # ###### ## ###### # # ## #
# ## # # #    # ## #    # # # ## #
# #  # # #### # ## # #### # #  # #
# ## # #      #    #      # # ## #
# ## # # ################ # # ## #
# ## # # #              # # # ## #
# ## # # # ## # ## #### # # # ## #
# ## # # #  # # ## # #  # # # ## #
# ## # ###### # ## # ###### # ## #
#    #        # ##        # #    #
############### ################ #
#               #                #
# ###################### #########
# ##                          ## #
# ## ########## ## ########## ## #
# ## #          ##          # ## #
# ## # # ###### ## ###### # # ## #
# ## # # #    # ## #    # # # ## #
# #  # # #### # ## # #### # #    #
# ## # #      # ## #      # # ## #
# ## # # ################ # # ## #
# ## # # #      ##      # # # ## #
# ## # # # ## # ## # ## # # # ## #
# ## # # #  # # ## # #  # # # ## #
#### # ###### # ## # ###### #### #
#    #        # ## #        #    #
#############################S####